____________R_______
_FFFF_______R_______
_F_F________R_______
__F_F_______RRRRRRRR
_F_F________R_______
_FFFF_______R_______
____________R_______
____________#_______
_HHH________#_______
_HHH________R_______
_HHH________#_______
____________R_______